NO	./rsrc/textures/42.xpm
SO	./rsrc/textures/distributeur.xpm
WE	./rsrc/textures/porte_ext.xpm
EA	./rsrc/textures/vide.xpm
C	181,222,150
F	57,87,74





11111
        1111111111111111111111111
        1000000000110000000000001
        1011000001110000000000001
        1001000000000000000000001
111111111011000001110000000000001
10000000001100000111011111111111111111
11110111111111011100000010011
11110111111111011101010010001
11000000110101011100000010001
1000000000S000001100000010101
10000000000000001101010010001
1100000111010101111101111000111
11110111 1110101 101111010001
11111111 1111111 111111111111
