EA	./rsrc/textures/tableau42.xpm
NO	./rsrc/textures/wall.xpm
SO	./rsrc/textures/wall.xpm
WE	./rsrc/textures/wall.xpm
C	181,222,222
F	57,87,74


        1111111111111111111111111
        1000000000110000101000001
        1011000001110000101000001
        1001000000000000101000001
1111111110110000011100001N100001
10000000001100001110111111111111
11110111111111011100000010001
11110111111111011101010010001111
11000000110101011100000010001
10000000000000001100000010001
10000000000000001101010010001
11000001110101011111011110001
11110111 1110101 101111010001
11111111 1111111 111111111111
