EA	./rsrc/textures/vide.xpm
NO	./rsrc/textures/tableau42.xpm
SO	./rsrc/textures/distributeur.xpm
WE	./rsrc/textures/porte_ext.xpm
C    181,222,222
F    57,87,74

11111111111
111111111111111111
1111111111111111111111111
1000000000110000101000001
1011000001110000101000001
1001000000000000101000001
1111111110110000011100001
1111111111111111111111111
10000000001100001110111111111111
1111011111111101111111111111
11111111111111011101010010001111
10111000000110101011100000010001
11111101000000000000000011000S111111
1111011000000000110101001000111
11000001110101011111011110001
11110111 1110101 101111 10001
11111111 1111111 111111 11111
