EA	./rsrc/textures/porte_ext.xpm
NO	./rsrc/textures/vide.xpm
SO	./rsrc/textures/42.xpm
WE	./rsrc/textures/porte.xpm

C	238,225,207
F	255,235,205

1111111111111111111111                         11111111111111111111111111
1000000000000000000001                         10000000000000000000000001
1000000000000000000001                         10000000000000000000000001
1000000111111110000001                         10000000000000000000000001
1000000100000010000001                         10000000000000000000000001
1000000100000010000001111111111111111111111111110000000001111110000000001
1000000100000010000001000000000000000000000000010000000000000000000000001
1000000100000010000001000000000000000000000000010000000000000000000000001
1000000111111110000001000000000000000000000000010000000001111110000000001
10000000000000000000000000000000000000000000000000N0000000000000000000001
1111111111111111111111111111111111111111111111111111111111111111111111111
