EA    ./rsrc/textures/rules.xpm
NO    ./rsrc/textures/brat.xpm
SO    ./rsrc/textures/freak.xpm
WE    ./rsrc/textures/tired.xpm

C    138,206,0
F    138,206,0

111111
11111111111
111111111111111111
1111111111111111111111111
1000000000110000101000001
1011000001110000101000001
1001000000000000000000001
11111111101100000111000011111111
10000000001100001110111111111111
11110111111111011111111111
1111111111111101110101001000111
10111000000110101011100000010001
11111101000000000000000000000S1
111111111111011000000000110101
11000001110101011111011110001
11110111111010110111110001111
11111111111111111111111111
11111111111
111111111111111111
1111111111111111111111111
1000000000110000101000001
1011000001110000101000001
1001000000000000000000001
11111111101100000111000011111111
10000000001100001110111111111111
1111011111111101111111111111
1111111111111101110101001000111
10111000000110101011100000010001
1111110100000000000000000000001
111111111111011000000000110101
11000001110101011111011110001
11110111111010110111110001111
11111111111111111111111111

1111










111111111111111111111

