EA	./rsrc/textures/vide.xpm
NO	./rsrc/textures/42.xpm
SO	./rsrc/textures/distributeur.xpm
WE	./rsrc/textures/porte_ext.xpm

C    124,252,0
F    255,0,255

	                      111        111
                         111111     11111
                        111111111111111111
                    1111111111111111111111111
                    1000000000110000101000001
                    1011000001110000101000001
                    1001000000000000101000001
                    11111111101100000111000011111111
                    10000000001100001110111111111111
                    11110111111111011111111111
                11111111111111011101010010001
            10111000000110101011100000010001
			11111101000000000000000011000S1
    111111111111011000000000110101001000111
            11000001110101011111011110001
            11110111 1110101 101111 10001
            11111111 1111111 111111 11111
