EA	./rsrc/textures/corgidrowning.xpm
NO	./rsrc/textures/fatdog.xpm
SO	./rsrc/textures/angrydog.xpm
WE	./rsrc/textures/illuminati.xpm
C	240,255,255
F	245,222,179
                          111        111
                         111111     11111
                        111111111111111111
                    1111111111111111111111111
                    1000000000110000101000001
                    1011000001110000101000001
                    1001000000000000000000001
                    11111111101100000111000011111111
                    10000000001100001110111111111111
                    11110111111111011111111111
                11111111111111011101010010001
            10111000000110101011100000010001
            11111101000000000000000000000S1
    111111111111011000000000110101000000111
            11000001110101011111011110001
            11110111 1110101 101111 10001
            11111111 1111111 111111 11111
