



NO	./rsrc/textures/42.xpm
SO	./rsrc/textures/distributeur.xpm
WE	./rsrc/textures/porte_ext.xpm
EA	./rsrc/textures/vide.xpm

C	218, 247, 166
F	 199, 0, 57

        1111111111111111111111111
        1000000000110000000000001
        1011000001110000000000001
        1001000000000000000000001
111111111011000001110000000000001
10000000001100000111011110001S01111
1111011111111101110000001000011
111101111111110111010100100011
11000000110101011100000010001
10000000000000001100000010001
10000000000000001101010010001
1100000111010101111101111000111111
11110111 1110101 101111010001
11111111 1111111 111111111111
